{
  "levels": [
    {
      "name": "Niveau 1 - L'aventure commence",
      "data": [
        "1111111111",
        "1000000001",
        "100C000001",
        "1000000001",
        "10000C0001",
        "1000000001",
        "10000C0001",
	  "1000000001",
        "10000C0001",
        "1000000E01",
        "1111111111"
      ],
      "collectibles": 4
    },
    {
      "name": "Niveau 2 - Le labyrinthe",
      "data": [
        "1111111111111",
        "1P00010000001",
        "100010000C001",
        "1000001000001",
        "100C000100001",
        "100000100C001",
        "1000100000001",
        "1000001000E01",
        "1111111111111"
      ],
      "collectibles": 3
    },
    {
      "name": "Niveau 3 - Le défi final",
      "data": [
        "11111111111111111",
        "1P0100000C0000001",
        "1000010000000C001",
        "100C0000100000001",
        "1000000C000100001",
        "1000000000C010001",
        "10000000000010001",
	  "10000000000010001",
	  "10000000000010001",
	  "10000100000000E01",
        "11111111111111111"
      ],
      "collectibles": 5
    }
  ]
}